1111111111111111111111111111
1E10000000000000000000000001
1010000000C00000000000000001
1000000000000000000000000001
1000000000C00000000000000001
1000000000000000000000000001
1000000011000000000000000001
1000000000000000000000000001
1000000111000000000000000001
1000000000000000000000000001
100P000000000000000000000001
1000000000000000000000000001
1111111111111111111111111111
